S /Users/aouchaad/Desktop/pics/redbrick.png

EA /Users/aouchaad/Desktop/pics/eagle.png
WE /Users/aouchaad/Desktop/pics/greystone.png
NO /Users/aouchaad/Desktop/pics/colorstone.png



C 100,100,100
F 255,0,0


1111111111111111111111111111111111111111111
1000000000000000000000000000000000000000001
1000000000000000000000000000000000000000001
1111111111111111111100000000000111111111111
1110000000000000000000000000000000000000001
1000010000100000001000100001000001000010001
11111111111100000000000000000000000000000011
11100000000000011111111111111100000000000001
11000000000000000N00000000000000000000111111
11000000000000000000000000000111111000000001
11110000000001111100000000010000000000001111
11000000000000000000000000000111000000000111
11100000000011110000000001111000000000111111
11000000000000000000000000000000000001111111
10000000000000000000000000000000000000000011
11000000000000000000000111111000000011111111
11111111111111111111111011111111111111111111
11111111111111111111111111111111 11111111111
