    111111

        10     0001
100001
111111
                111111111




                