S textures/pics/redbrick.png

EA textures/pics/eagle.png
WE textures/pics/greystone.png
NO textures/pics/colorstone.png



C 100,100,100
F 255,0,0


111111111111111111111111111111111
111111111000000000110000000000001
111111111011000001110000001000001
111111111001000000000000010000001
1111111110110000011100S0000000001
100000000011000001110111111111111
11110111111111011100000010001
111101111111110111111100000001111111
110000001101010111    1100000010001
100000000000000011     100000000001
100000000000000011     1010100100011
110000011101010111     1101111000111
111101111111010111     1011110100011
111111111111111111     111111111111
