S ./textures/so.xpm


F 225,100,0
EA ./textures/ea.xpm
WE ./textures/we.xpm
NO ./textures/no.xpm



C 255,30,0

111111111111111111111111111111111
111111111000000000110000000000001
111111111011000001110000000000001
111111111001000000000000000000001
111111111011000001110000000000001
100000000011000001110111111111111
11110111111111011100000010001
11110111111111011101010010001
11000000110101011100000010001
10000000000000001100000000001
100000000000000011010100100011
11000001110101011111011110N0111
1111011111110101111011110100011
111111111111111111111111111111