SO                textures/pics/redbrick.png
EA          textures/pics/eagle.png
C         225,150,35
WE textures/pics/greystone.png            
NO          textures/pics/colorstone.png
F       100,100,+100


  1111111111111
  1111111011111
 10000000N000001
  11111111111111