SO textures/pics/redbrick.png

EA textures/pics/eagle.png
WE textures/pics/greystone.png
NO textures/pics/colorstone.png

C 100,100,200

F 202,220,120


111111111111111111111111111111111
111111111000000000110000000000001
111111110011000001100000010000001
1111100D00W0100000000001D110000001
111111110011000001110000000000001
100000000011000001110111111111111
11110111111111011100000010001
1111D1111111110111111100000001111111
110001101010111    1100000010001
1000000000000011     100000000001
1000000000000011     1010100100011
1100000111001010111   1101111000111
111101111111010111     1011110100011
111111111111111111     111111111111
